     #################
     #        #     F#####################
     #    #  E#                          #
     #    #####      ################### #
     #               #                 # #
###################  ################# # #
#                                    # # #
#  ##############                    # # #
#               #####                # # #
# #############     #                # # #
# #                 #                # # #
############  ######################## # #
         #L                    #       # #
         #           #     #   ######### #
         #           #     #             #
         ##########  #     #   ###########
         #           #     #   #
         #           #######   #
         #           #     #   #
         #           #     #   #
         #           #     #  S#
         #######################