# ######
##     #
#S ##  #
## ##  #
#      #
# ###  #
#      #
########