#########
#F      #
# ##### #
# #   # #
# # L # #
# #   # #
# ##### #
#       #
#########